Data: A collection of facts (Course 1 Week 1)
Data analysis: The collection, transformation, and organization of data in order to draw conclusions, make predictions, and drive informed decision-making (Course 1 Week 1)
Data analyst: Someone who collects, transforms, and organizes data in order to draw conclusions, make predictions, and drive informed decision-making (Course 1 Week 1)
Data analytics: The science of data (Course 1 Week 1)
Data-driven decision-making: Using facts to guide business strategy (Course 1 Week 1)
Data ecosystem: The various elements that interact with one another in order to produce, manage, store, organize, analyze, and share data (Course 1 Week 1)
Data science: A field of study that uses raw data to create new ways of modeling and understanding the unknown (Course 1 Week 1)
Dataset: A collection of data that can be manipulated or analyzed as one unit (Course 1 Week 1)
Analytical skills: Qualities and characteristics associated with using facts to solve problems (Course 1 Week 2)
Analytical thinking: The process of identifying and defining a problem, then solving it by using data in an organized, step-by-step manner (Course 1 Week 2)
Context: The condition in which something exists or happens (Course 1 Week 2)
Data design: How information is organized (Course 1 Week 2)
Data strategy: The management of the people, processes, and tools used in data analysis (Course 1 Week 2)
Data visualization: The graphical representation of data (Course 1 Week 2)
Gap analysis: A method for examining and evaluating the current state of a process in order to identify opportunities for improvement in the future (Course 1 Week 2)
Root cause: The reason why a problem occurs (Course 1 Week 2)
Technical mindset: The ability to break things down into smaller steps or pieces and work with them in an orderly and logical way (Course 1 Week 2)
Visualization: (Refer to Data visualization) (Course 1 Week 2)
Database: A collection of data stored in a computer system (Course 1 Week 3)
Formula: A set of instructions used to perform a calculation using the data in a spreadsheet (Course 1 Week 3)
Function: A preset command that automatically performs a specific process or task using the data in a spreadsheet (Course 1 Week 3)
Query language: A computer programming language used to communicate with a database (Course 1 Week 3)
Stakeholders: People who invest time and resources into a project and are interested in its outcome (Course 1 Week 3)
Attribute: A characteristic or quality of data used to label a column in a table (Course 1 Week 4)
Observation: The attributes that describe a piece of data contained in a row of a table (Course 1 Week 4)
Query: A request for data or information from a database (Course 1 Week 4)
Business task: The question or problem data analysis resolves for a business (Course 1 Week 5)
Fairness: A quality of data analysis that does not create or reinforce bias (Course 1 Week 5)
Action-oriented question: A question whose answers lead to change (Course 2 Week 1)
Cloud: A place to keep data online, rather than a computer hard drive (Course 2 Week 1)
Data analysis process: The six phases of ask, prepare, process, analyze, share, and act whose purpose is to gain insights that drive informed decision-making (Course 2 Week 1)
Data life cycle: The sequence of stages that data experiences, which include plan, capture, manage, analyze, archive, and destroy (Course 2 Week 1)
Leading question: A question that steers people toward a certain response (Course 2 Week 1)
Measurable question: A question whose answers can be quantified and assessed (Course 2 Week 1)
Problem types: The various problems that data analysts encounter, including categorizing things, discovering connections, finding patterns, identifying themes, making predictions, and spotting something unusual (Course 2 Week 1)
Relevant question: A question that has significance to the problem to be solved (Course 2 Week 1)
SMART methodology: A tool for determining a question’s effectiveness based on whether it is specific, measurable, action-oriented, relevant, and time-bound (Course 2 Week 1)
Specific question: A question that is simple, significant, and focused on a single topic or a few closely related ideas (Course 2 Week 1)
Spreadsheet: A digital worksheet (Course 2 Week 1)
Structured thinking: The process of recognizing the current problem or situation, organizing available information, revealing gaps and opportunities, and identifying options (Course 2 Week 1)
Time-bound question: A question that specifies a timeframe to be studied (Course 2 Week 1)
Unfair question: A question that makes assumptions or is difficult to answer honestly (Course 2 Week 1)
Algorithm: A process or set of rules followed for a specific task (Course 2 Week 2)
Big data: Large, complex datasets typically involving long periods of time, which enable data analysts to address far-reaching business problems (Course 2 Week 2)
Dashboard: A tool that monitors live, incoming data (Course 2 Week 2)
Data-inspired decision-making: Exploring different data sources to find out what they have in common (Course 2 Week 2)
Metric: A single, quantifiable type of data that is used for measurement (Course 2 Week 2)
Metric goal: A measurable goal set by a company and evaluated using metrics (Course 2 Week 2)
Pivot chart: A chart created from the fields in a pivot table (Course 2 Week 2)
Pivot table: A data summarization tool used to sort, reorganize, group, count, total, or average data (Course 2 Week 2)
Qualitative data: A subjective and explanatory measure of a quality or characteristic (Course 2 Week 2)
Quantitative data: A specific and objective measure, such as a number, quantity, or range (Course 2 Week 2)
Report: A static collection of data periodically given to stakeholders (Course 2 Week 2)
Return on investment (ROI): A formula that uses the metrics of investment and profit to evaluate the success of an investment (Course 2 Week 2)
Revenue: The total amount of income generated by the sale of goods or services (Course 2 Week 2)
Small data: Small, specific data points typically involving a short period of time, which are useful for making day-to-day decisions (Course 2 Week 2)
SQL: (Refer to Structured Query Language) (Course 2 Week 2)
Structured Query Language: A computer programming language used to communicate with a database (Course 2 Week 2)
AVERAGE: A spreadsheet function that returns an average of the values from a selected range (Course 2 Week 3)
Borders: Lines that can be added around two or more cells on a spreadsheet (Course 2 Week 3)
Cell reference: A cell or a range of cells in a worksheet typically used in formulas and functions (Course 2 Week 3)
COUNT: A spreadsheet function that counts the number of cells within a range the meet a specified condition (Course 2 Week 3)
Equation: A calculation that involves addition, subtraction, multiplication, or division (also called a math expression) (Course 2 Week 3)
Fill handle: A box in the lower-right-hand corner of a selected spreadsheet cell that can be dragged through neighboring cells in order to continue an instruction (Course 2 Week 3)
Filtering: The process of showing only the data that meets a specified criteria while hiding the rest (Course 2 Week 3)
Header: The first row in a spreadsheet that labels the type of data in each column (Course 2 Week 3)
Math expression: A calculation that involves addition, subtraction, multiplication, or division (also called an equation) (Course 2 Week 3)
Math function: A function that is used as part of a mathematical formula (Course 2 Week 3)
MAX: A function that returns the largest numeric value from a range of cells (Course 2 Week 3)
MIN: A spreadsheet function that returns the smallest numeric value from a range of cells (Course 2 Week 3)
Open data: Data that is available to the public (Course 2 Week 3)
Operator: A symbol that names the operation or calculation to be performed (Course 2 Week 3)
Order of operations: Using parentheses to group together spreadsheet values in order to clarify the order in which operations should be performed (Course 2 Week 3)
Problem domain: The area of analysis that encompasses every activity affecting or affected by a problem (Course 2 Week 3)
Range: A collection of two or more cells in a spreadsheet (Course 2 Week 3)
Scope of work (SOW): An agreed-upon outline of the tasks to be performed during a project (Course 2 Week 3)
Sorting: The process of arranging data into a meaningful order to make it easier to understand, analyze, and visualize (Course 2 Week 3)
SUM: A spreadsheet function that adds the values of a selected range of cells (Course 2 Week 3)
Reframing: The process of restating a problem or challenge, then redirecting it toward a potential resolution (Course 2 Week 4)
Turnover rate: The rate at which employees voluntarily leave a company (Course 2 Week 4)
Agenda: A list of scheduled appointments (Course 3 Week 1)
Audio file: Digitized audio storage usually in an MP3, AAC, or other compressed format (Course 3 Week 1)
Boolean data: A data type with only two possible values, usually true or false (Course 3 Week 1)
Continuous data: Data that is measured and can have almost any numeric value (Course 3 Week 1)
Cookie: A small file stored on a computer that contains information about its users (Course 3 Week 1)
Data element: A piece of information in a dataset (Course 3 Week 1)
Data model: A tool for organizing data elements and how they relate to one another (Course 3 Week 1)
Data type: An attribute that describes a piece of data based on its values, its programming language, or the operations it can perform (Course 3 Week 1)
Digital photo: An electronic or computer-based image usually in BMP or JPG format (Course 3 Week 1)
Discrete data: Data that is counted and has a limited number of values (Course 3 Week 1)
External data: Data that lives, and is generated, outside of an organization (Course 3 Week 1)
Field: A single piece of information from a row or column of a spreadsheet; in a data table, typically a column in the table (Course 3 Week 1)
First-party data: Data collected by an individual or group using their own resources (Course 3 Week 1)
Internal data: Data that lives within a company’s own systems (Course 3 Week 1)
Long data: A dataset in which each row is one time point per subject, so each subject has data in multiple rows (Course 3 Week 1)
Nominal data: A type of qualitative data that is categorized without a set order (Course 3 Week 1)
Ordinal data: Qualitative data with a set order or scale (Course 3 Week 1)
Ownership: The aspect of data ethics that presumes individuals own the raw data they provide and have primary control over its usage, processing, and sharing (Course 3 Week 1)
Pixel: In digital imaging, a small area of illumination on a display screen that, when combined with other adjacent areas, forms a digital image (Course 3 Week 1)
Population: In data analytics, all possible data values in a dataset (Course 3 Week 1)
Record: A collection of related data in a data table, usually synonymous with row (Course 3 Week 1)
Relational database: A database that contains a series of tables that can be connected to form relationships (Course 3 Week 1)
Sample: In data analytics, a segment of a population that is representative of the entire population (Course 3 Week 1)
Second-party data: Data collected by a group directly from its audience and then sold (Course 3 Week 1)
Social media: Websites and applications through which users create and share content or participate in social networking (Course 3 Week 1)
String data type: A sequence of characters and punctuation that contains textual information (also called text data type) (Course 3 Week 1)
Structured data: Data organized in a certain format such as rows and columns (Course 3 Week 1)
Text data type: A sequence of characters and punctuation that contains textual information (also called string data type) (Course 3 Week 1)
Third-party data: Data provided from outside sources who didn’t collect it directly (Course 3 Week 1)
United States Census Bureau: An agency in the U.S. Department of Commerce that serves as the nation’s leading provider of quality data about its people and economy (Course 3 Week 1)
Unstructured data: Data that is not organized in any easily identifiable manner (Course 3 Week 1)
Video file: A collection of images, audio files, and other data usually encoded in a compressed format such as MP4, MV4, MOV, AVI, or FLV (Course 3 Week 1)
Wide data: A dataset in which every data subject has a single row with multiple columns to hold the values of various attributes of the subject (Course 3 Week 1)
Bad data source: A data source that is not reliable, original, comprehensive, current, and cited (ROCCC) (Course 3 Week 2)
Bias: A conscious or subconscious preference in favor of or against a person, group of people, or thing (Course 3 Week 2)
Confirmation bias: The tendency to search for or interpret information in a way that confirms pre-existing beliefs (Course 3 Week 2)
Consent: The aspect of data ethics that presumes an individual’s right to know how and why their personal data will be used before agreeing to provide it (Course 3 Week 2)
Currency: The aspect of data ethics that presumes individuals should be aware of financial transactions resulting from the use of their personal data and the scale of those transactions (Course 3 Week 2)
Data anonymization: The process of protecting people's private or sensitive data by eliminating identifying information (Course 3 Week 2)
Data bias: When a preference in favor of or against a person, group of people, or thing systematically skews data analysis results in a certain direction (Course 3 Week 2)
Data ethics: Well-founded standards of right and wrong that dictate how data is collected, shared, and used (Course 3 Week 2)
Data interoperability: The ability to integrate data from multiple sources and a key factor leading to the successful use of open data among companies and governments (Course 3 Week 2)
Data privacy: Preserving a data subject’s information any time a data transaction occurs (Course 3 Week 2)
Ethics: Well-founded standards of right and wrong that prescribe what humans ought to do, usually in terms of rights, obligations, benefits to society, fairness, or specific virtues (Course 3 Week 2)
Experimenter bias: The tendency for different people to observe things differently (Refer to Observer bias) (Course 3 Week 2)
General Data Protection Regulation of the European Union (GDPR): Policy-making body in the European Union created to help protect people and their data (Course 3 Week 2)
Good data source: A data source that is reliable, original, comprehensive, current, and cited (ROCCC) (Course 3 Week 2)
Interpretation bias: The tendency to interpret ambiguous situations in a positive or negative way (Course 3 Week 2)
Observer bias: The tendency for different people to observe things differently (also called experimenter bias) (Course 3 Week 2)
Openness: The aspect of data ethics that promotes the free access, usage, and sharing of data (Course 3 Week 2)
Sampling bias: Overrepresenting or underrepresenting certain members of a population as a result of working with a sample that is not representative of the population as a whole (Course 3 Week 2)
Transaction transparency: The aspect of data ethics that presumes all data-processing activities and algorithms should be explainable and understood by the individual who provides the data (Course 3 Week 2)
Unbiased sampling: When the sample of the population being measured is representative of the population as a whole (Course 3 Week 2)
Administrative metadata: Metadata that indicates the technical source of a digital asset (Course 3 Week 3)
CSV (comma-separated values) file: A delimited text file that uses a comma to separate values (Course 3 Week 3)
Data governance: A process for ensuring the formal management of a company’s data assets (Course 3 Week 3)
Descriptive metadata: Metadata that describes a piece of data and can be used to identify it at a later point in time (Course 3 Week 3)
Foreign key: A field within a database table that is a primary key in another table (Refer to primary key) (Course 3 Week 3)
FROM: The section of a query that indicates from which table(s) to extract the data (Course 3 Week 3)
Geolocation: The geographical location of a person or device by means of digital information (Course 3 Week 3)
Metadata: Data about data (Course 3 Week 3)
Metadata repository: A database created to store metadata (Course 3 Week 3)
Naming conventions: Consistent guidelines that describe the content, creation date, and version of a file in its name (Course 3 Week 3)
Normalized database: A database in which only related data is stored in each table (Course 3 Week 3)
Notebook: An interactive, editable programming environment for creating data reports and showcasing data skills (Course 3 Week 3)
Primary key: An identifier in a database that references a column in which each value is unique (Refer to foreign key) (Course 3 Week 3)
Redundancy: When the same piece of data is stored in two or more places (Course 3 Week 3)
Schema: A way of describing how something, such as data, is organized (Course 3 Week 3)
SELECT: The section of a query that indicates from which column(s) to extract the data (Course 3 Week 3)
Structural metadata: Metadata that indicates how a piece of data is organized and whether it is part of one or more than one data collection (Course 3 Week 3)
WHERE: The section of a query that specifies criteria that the requested data must meet (Course 3 Week 3)
World Health Organization: An organization whose primary role is to direct and coordinate international health within the United Nations system (Course 3 Week 3)
Access control: Features such as password protection, user permissions, and encryption that are used to protect a spreadsheet (Course 3 Week 4)
Agenda (in Google Calendar): A view of scheduled appointments (Course 3 Week 4)
CSV (Comma-separated values file): A delimited text file that uses a comma to separate values (Course 3 Week 4)
Data security: Protecting data from unauthorized access or corruption by adopting safety measures (Course 3 Week 4)
Inbox: Electronic storage where emails received by an individual are held (Course 3 Week 4)
Mentor: Someone who shares knowledge, skills, and experience to help another grow both professionally and personally (Course 3 Week 6)
Networking: Building relationships by meeting people both in person and online (Course 3 Week 6)
Sponsor: A professional advocate who is committed to moving forward the career of another (Course 3 Week 6)
A/B testing: The process of testing two variations of the same web page to determine which page is more successful at attracting user traffic and generating revenue (Course 4 Week 1)
Accuracy: The degree to which data conforms to the actual entity being measured or described (Course 4 Week 1)
Completeness: The degree to which data contains all desired components or measures (Course 4 Week 1)
Confidence interval: A range of values that conveys how likely a statistical estimate reflects the population (Course 4 Week 1)
Confidence level: The probability that a sample size accurately reflects the greater population (Course 4 Week 1)
Consistency: The degree to which data is repeatable from different points of entry or collection (Course 4 Week 1)
Cross-field validation: A process that ensures certain conditions for multiple data fields are satisfied (Course 4 Week 1)
Data constraints: The criteria that determine whether a piece of a data is clean and valid (Course 4 Week 1)
Data integrity: The accuracy, completeness, consistency, and trustworthiness of data throughout its life cycle (Course 4 Week 1)
Data manipulation: The process of changing data to make it more organized and easier to read (Course 4 Week 1)
Data range: Numerical values that fall between predefined maximum and minimum values (Course 4 Week 1)
Data replication: The process of storing data in multiple locations (Course 4 Week 1)
Data transfer: The process of copying data from a storage device to computer memory or from one computer to another (Course 4 Week 1)
DATEDIF: A spreadsheet function that calculates the number of days, months, or years between two dates (Course 4 Week 1)
Estimated response rate: The average number of people who typically complete a survey (Course 4 Week 1)
Hypothesis testing: A process to determine if a survey or experiment has meaningful results (Course 4 Week 1)
Mandatory: A data value that cannot be left blank or empty (Course 4 Week 1)
Margin of error: The maximum amount that sample results are expected to differ from those of the actual population (Course 4 Week 1)
Random sampling: A way of selecting a sample from a population so that every possible type of the sample has an equal chance of being chosen (Course 4 Week 1)
Regular expression (RegEx): A rule that says the values in a table must match a prescribed pattern (Course 4 Week 1)
Statistical power: The probability that a test of significance will recognize an effect that is present (Course 4 Week 1)
Statistical significance: The probability that sample results are not due to random chance (Course 4 Week 1)
Unique: A value that can’t have a duplicate (Course 4 Week 1)
Validity: The degree to which data conforms to constraints when it is input, collected, or created (Course 4 Week 1)
VLOOKUP: A spreadsheet function that vertically searches for a certain value in a column to return a corresponding piece of information (Course 4 Week 1)
Clean data: Data that is complete, correct, and relevant to the problem being solved (Course 4 Week 2)
Compatibility: How well two or more datasets are able to work together (Course 4 Week 2)
CONCATENATE: A spreadsheet function that joins together two or more text strings (Course 4 Week 2)
Conditional formatting: A spreadsheet tool that changes how cells appear when values meet specific conditions (Course 4 Week 2)
COUNTIF: A spreadsheet function that returns the number of cells within a range that match a specified value (Course 4 Week 2)
Data engineer: A professional who transforms data into a useful format for analysis and gives it a reliable infrastructure (Course 4 Week 2)
Data mapping: The process of matching fields from one data source to another (Course 4 Week 2)
Data merging: The process of combining two or more datasets into a single dataset (Course 4 Week 2)
Data validation: A tool for checking the accuracy and quality of data (Course 4 Week 2)
Data warehousing specialist: A professional who develops processes and procedures to effectively store and organize data (Course 4 Week 2)
Delimiter: A character that indicates the beginning or end of a data item (Course 4 Week 2)
Dirty data: Data that is incomplete, incorrect, or irrelevant to the problem to be solved (Course 4 Week 2)
Duplicate data: Any record that inadvertently shares data with another record (Course 4 Week 2)
Field length: A tool for determining how many characters can be keyed into a spreadsheet field (Course 4 Week 2)
Incomplete data: Data that is missing important fields (Course 4 Week 2)
Inconsistent data: Data that uses different formats to represent the same thing (Course 4 Week 2)
Incorrect/inaccurate data: Data that is complete but inaccurate (Course 4 Week 2)
LEFT: A function that returns a set number of characters from the left side of a text string (Course 4 Week 2)
LEN: A function that returns the length of a text string by counting the number of characters it contains (Course 4 Week 2)
Length: The number of characters in a text string (Course 4 Week 2)
Merger: An agreement that unites two organizations into a single new one (Course 4 Week 2)
MID: A function that returns a segment from the middle of a text string (Course 4 Week 2)
Null: An indication that a value does not exist in a dataset (Course 4 Week 2)
Outdated data: Any data that has been superseded by newer and more accurate information (Course 4 Week 2)
Remove duplicates: A spreadsheet tool that automatically searches for and eliminates duplicate entries from a spreadsheet (Course 4 Week 2)
RIGHT: A function that returns a set number of characters from the right side of a text string (Course 4 Week 2)
Split: A spreadsheet function that divides text around a specified character and puts each fragment into a new, separate cell (Course 4 Week 2)
Substring: A subset of a text string (Course 4 Week 2)
Syntax: The predetermined structure of a language that includes all required words, symbols, and punctuation, as well as their proper placement (Course 4 Week 2)
Text string: A group of characters within a cell, most often composed of letters (Course 4 Week 2)
TRIM: A function that removes leading, trailing, and repeated spaces in data (Course 4 Week 2)
CAST: A SQL function that converts data from one datatype to another (Course 4 Week 3)
COALESCE: A SQL function that returns non-null values in a list (Course 4 Week 3)
CONCAT: A SQL function that adds strings together to create new text strings that can be used as unique keys (Course 4 Week 3)
DISTINCT: A keyword that is added to a SQL SELECT statement to retrieve only non-duplicate entries (Course 4 Week 3)
Float: A number that contains a decimal (Course 4 Week 3)
SUBSTR: A SQL function that extracts a substring from a string variable (Course 4 Week 3)
Typecasting: Converting data from one type to another (Course 4 Week 3)
CASE: A SQL statement that returns records that meet conditions by including an if/then statement in a query (Course 4 Week 4)
Changelog: A file containing a chronologically ordered list of modifications made to a project (Course 4 Week 4)
COUNTA: A spreadsheet function that counts the total number of values within a specified range that meet specified criteria (Course 4 Week 4)
Find and replace: A tool that finds a specified search term and replaces it with something else (Course 4 Week 4)
Verification: A process to confirm that a data-cleaning effort was well executed and the resulting data is accurate and reliable (Course 4 Week 4)
Soft skills: Nontechnical traits and behaviors that relate to how people work (Course 4 Week 6)
Transferable skills: Skills and qualities that can transfer from one job or industry to another (Course 4 Week 6)
ORDER BY: A SQL clause that sorts results returned in a query (Course 5 Week 1)
ROUND: A SQL function that returns a number rounded to a certain number of decimal places. (Course 5 Week 2)
Absolute reference: A reference within a function that is locked so that rows and columns won’t change if the function is copied (Course 5 Week 3)
Aggregation: The process of collecting or gathering many separate pieces into a whole (Course 5 Week 3)
Aliasing: Temporarily naming a table or column in a query to make it easier to read and write (Course 5 Week 3)
COUNT DISTINCT: A SQL function that only returns the distinct values in a specified range (Course 5 Week 3)
Data aggregation: The process of gathering data from multiple sources and combining it into a single, summarized collection (Course 5 Week 3)
INNER JOIN: A SQL function that returns records with matching values in both tables (Course 5 Week 3)
JOIN: A SQL function that is used to combine rows from two or more tables based on a related column (Course 5 Week 3)
LEFT JOIN: A SQL function that will return all the records from the left table and only the matching records from the right table (Course 5 Week 3)
LIMIT: A SQL clause that specifies the maximum number of records returned in a query (Course 5 Week 3)
MATCH: A spreadsheet function used to locate the position of a specific lookup value (Course 5 Week 3)
OUTER JOIN: A SQL function that combines RIGHT and LEFT JOIN to return all matching records in both tables (Course 5 Week 3)
RIGHT JOIN: A SQL function that will return all records from the right table and only the matching records from the left (Course 5 Week 3)
Subquery: A SQL query that is nested inside a larger query (Course 5 Week 3)
VALUE: A spreadsheet function that converts a text string that represents a number to a numeric value (Course 5 Week 3)
Array: A collection of values in spreadsheet cells (Course 5 Week 4)
Calculated field: A new field within a pivot table that carries out certain calculations based on the values of other fields (Course 5 Week 4)
Data validation process: The process of checking and rechecking the quality of data so that it is complete, accurate, secure and consistent (Course 5 Week 4)
GROUP BY: A SQL clause that groups rows that have the same values from a table into summary rows (Course 5 Week 4)
Modulo: An operator (%) that returns the remainder when one number is divided by another (Course 5 Week 4)
Profit margin: A percentage that indicates how many cents of profit has been generated for each dollar of sale (Course 5 Week 4)
Summary table: A table used to summarize statistical information about data (Course 5 Week 4)
SUMPRODUCT: A function that multiplies arrays and returns the sum of those products (Course 5 Week 4)
Temporary table: A database table that is created and exists temporarily on a database server (Course 5 Week 4)
Underscores: Lines used to underline words and connect text characters (Course 5 Week 4)
Alternative text: Text that provides an alternative to non-text content, such as images and videos (Course 6 Week 1)
Annotation: Text that briefly explains data or helps focus the audience on a particular aspect of the data in a visualization (Course 6 Week 1)
AVERAGEIF: A spreadsheet function that returns the average of all cell values from a given range that meet a specified condition (Course 6 Week 1)
Balance: The design principle of creating aesthetic appeal and clarity in a data visualization by evenly distributing visual elements (Course 6 Week 1)
Bar graph: A data visualization that uses size to contrast and compare two or more values (Course 6 Week 1)
Calculus: A branch of mathematics that involves the study of rates of change and the changes between values that are related by a function (Course 6 Week 1)
Causation: When an action directly leads to an outcome, such as a cause-effect relationship (Course 6 Week 1)
Channel: A visual aspect or variable that represents characteristics of the data in a visualization (Course 6 Week 1)
Chart: A graphical representation of data from a worksheet (Course 6 Week 1)
Cluster: A collection of data points on a data visualization with similar values (Course 6 Week 1)
CONVERT: A SQL function that changes the unit of measurement of a value in data (Course 6 Week 1)
Correlation: The measure of the degree to which two variables change in relationship to each other (Course 6 Week 1)
CREATE TABLE: A SQL clause that adds a temporary table to a database that can be used by multiple people (Course 6 Week 1)
Data composition: The process of combining the individual parts in a visualization and displaying them together as a whole (Course 6 Week 1)
Decision tree: A tool that helps analysts make decisions about critical features of a visualization (Course 6 Week 1)
Design thinking: A process used to solve complex problems in a user-centric way (Course 6 Week 1)
Distribution graph: A data visualization that displays the frequency of various outcomes in a sample (Course 6 Week 1)
DROP TABLE: A SQL clause that removes a temporary table from a database (Course 6 Week 1)
Dynamic visualizations: Data visualizations that are interactive or change over time (Course 6 Week 1)
Emphasis: The design principle of arranging visual elements to focus the audience’s attention on important information in a data visualization (Course 6 Week 1)
HAVING: A SQL clause that adds a filter to a query instead of the underlying table that can only be used with aggregate functions (Course 6 Week 1)
Headline: Text at the top of a visualization that communicates the data being presented (Course 6 Week 1)
Heat map: A data visualization that uses color contrast to compare categories in a dataset (Course 6 Week 1)
Histogram: A data visualization that shows how often data values fall into certain ranges (Course 6 Week 1)
Inner query: A SQL subquery that is inside of another SQL statement (Course 6 Week 1)
Label: Text in a visualization that identifies a value or describes a scale (Course 6 Week 1)
Legend: A tool that identifies the meaning of various elements in a data visualization (Course 6 Week 1)
Line graph: A data visualization that uses one or more lines to display shifts or changes in data over time (Course 6 Week 1)
Map: A data visualization that organizes data geographically (Course 6 Week 1)
Mark: A visual object in a data visualization such as a point, line, or shape (Course 6 Week 1)
MAXIFS: A spreadsheet function that returns the maximum value from a given range that meets a specified condition (Course 6 Week 1)
Mental model: A data analyst’s thought process and approach to a problem (Course 6 Week 1)
Movement: The design principle of arranging visual elements to guide the audience’s eyes from one part of a data visualization to another (Course 6 Week 1)
MINIFS: A spreadsheet function that returns the minimum value from a given range that meets a specified condition (Course 6 Week 1)
Narrative: (Refer to Story) (Course 6 Week 1)
Pattern: The design principle of using similar visual elements to demonstrate trends and relationships in a data visualization (Course 6 Week 1)
Pie chart: A data visualization that uses segments of a circle to represent the proportions of each data category compared to the whole (Course 6 Week 1)
Pre-attentive attributes: The elements of a data visualization that an audience recognizes automatically without conscious effort (Course 6 Week 1)
Proportion: The design principle of using the relative size and arrangement of visual elements to demonstrate information in a data visualization (Course 6 Week 1)
R: A programming language used for statistical analysis, visualization, and other data analysis (Course 6 Week 1)
Ranking: A system to position values of a dataset within a scale of achievement or status (Course 6 Week 1)
Relativity: The process of considering observations in relation or proportion to something else (Course 6 Week 1)
Repetition: The design principle of repeating visual elements to demonstrate meaning in a data visualization (Course 6 Week 1)
Rhythm: The design principle of creating movement and flow in a data visualization to engage an audience (Course 6 Week 1)
Scatterplot: A data visualization that represents relationships between different variables with individual data points without a connecting line (Course 6 Week 1)
SELECT INTO: A SQL clause that copies data from one table into a temporary table without adding the new table to the database (Course 6 Week 1)
Sort range: A spreadsheet menu function that sorts a specified range and preserves the cells outside the range (Course 6 Week 1)
Sort sheet: A spreadsheet menu function that sorts all data by the ranking of a specific sorted column and keeps data together across rows (Course 6 Week 1)
Static visualization: A data visualization that does not change over time unless it is edited (Course 6 Week 1)
Story: The narrative of a data presentation that makes it meaningful and interesting (Course 6 Week 1)
Subtitle: Text that supports a headline by adding context and description (Course 6 Week 1)
Tableau: A business intelligence and analytics platform that helps people visualize, understand, and make decisions with data (Course 6 Week 1)
Unity: The design principle of using visual elements that complement each other to create aesthetic appeal and clarity in a data visualization (Course 6 Week 1)
Variety: The design principle of using different kinds of visual elements in a data visualization to engage an audience (Course 6 Week 1)
Visual form: The appearance of a data visualization that gives it structure and aesthetic appeal (Course 6 Week 1)
X-axis: The horizontal line of a graph usually placed at the bottom, which is often used to represent time scales and discrete categories (Course 6 Week 1)
Y-axis: The vertical line of a graph usually placed to the left, which is often used to represent frequencies and other numerical variables (Course 6 Week 1)
Area chart: A data visualization that uses individual data points for a changing variable connected by a continuous line with a filled in area underneath (Course 6 Week 2)
Box plot: A data visualization that displays the distribution of values along an x-axis (Course 6 Week 2)
Bubble chart: A data visualization that displays individual data points as bubbles, comparing numeric values by their relative size (Course 6 Week 2)
Bullet graph: A data visualization that displays data as a horizontal bar chart moving toward a desired value (Course 6 Week 2)
Circle view: A data visualization that shows comparative strength in data (Course 6 Week 2)
Column chart: A data visualization that uses individual data points for a changing variable, represented as vertical columns (Course 6 Week 2)
Combo chart: A data visualization that combines more than one visualization type (Course 6 Week 2)
Density map: A data visualization that represents concentrations, with color representing the number or frequency of data points in a given area on a map (Course 6 Week 2)
Diverging color palette: A color theme that displays two ranges of data values using two different hues, with color intensity representing the magnitude of the values (Course 6 Week 2)
Donut chart: A data visualization where segments of a ring represent data values adding up to a whole (Course 6 Week 2)
Filled map: A data visualization that colors areas in a map based on measurements or dimensions (Course 6 Week 2)
Gantt chart: A data visualization that displays the duration of events or activities on a timeline (Course 6 Week 2)
Gauge chart: A data visualization that shows a single result within a progressive range of values (Course 6 Week 2)
Highlight table: A data visualization that uses conditional formatting and color on a table (Course 6 Week 2)
Packed bubble chart: A data visualization that displays data in clustered circles (Course 6 Week 2)
Symbol map: A data visualization that displays a mark over a given longitude and latitude (Course 6 Week 2)
Outer query: A SQL statement containing a subquery (Course 6 Week 2)
SPLIT: A spreadsheet function that divides text around a specified character and puts each fragment into a new, separate cell (Course 6 Week 2)
Statistics: The study of how to collect, analyze, summarize, and present data (Course 6 Week 2)
SUMIF: A spreadsheet function that adds numeric data based on one condition (Course 6 Week 2)
WITH: A SQL clause that creates a temporary table that can be queried multiple times (Course 6 Week 2)
Data storytelling: Communicating the meaning of a dataset with visuals and a narrative that are customized for an audience (Course 6 Week 3)
Engagement: Capturing and holding someone’s interest and attention during a data presentation (Course 6 Week 3)
Live data: Data that is automatically updated (Course 6 Week 3)
Spotlightling: Scanning through data to quickly identify the most important insights (Course 6 Week 3)
Dashboard filter: A tool for showing only the data that meets a specific criteria while hiding the rest (Course 6 Week 4)
Data blending: A Tableau method that combines data from multiple data sources (Course 6 Week 4)
Framework: The context a presentation needs to create logical connections that tie back to the business task and metrics (Course 6 Week 4)
Professional relationship building: Building relationships by meeting people both in person and online (Refer to Networking) (Course 6 Week 4)
Static data: Data that doesn’t change once it has been recorded (Course 6 Week 4)
Business metric: A standard of measurement used to solve a business task (Course 7 Week 1)
Coding: The process of writing instructions to a computer in the syntax of a specific programming language (Course 7 Week 1)
Computer programming: The process of giving instructions to a computer in order to perform an action or set of actions (Course 7 Week 1)
CSS (Cascading Style Sheets): A programming language used for web page design that controls graphic elements and page presentation (Course 7 Week 1)
HTML5: A programming language that provides structure for web pages and connects to hosting platforms (Course 7 Week 1)
Hypothesis: A theory that one might try to prove or disprove with data (Course 7 Week 1)
IDE (Integrated Development Environment): A software application that brings together all the tools a data analyst may want to use in a single place (Course 7 Week 1)
Java: A programming language widely used to create enterprise web applications that can run on multiple clients (Course 7 Week 1)
McCandless Method: A method for presenting data visualizations that moves from general to specific information (Course 7 Week 1)
Open-source: Code that is freely available and may be modified and shared by the people who use it (Course 7 Week 1)
PHP (Hypertext Preprocessor): A programming language for web application development (Course 7 Week 1)
Portfolio: A collection of materials that can be shared with potential employers (Course 7 Week 1)
Programming language: A system of words and symbols used to write instructions that computers follow (Course 7 Week 1)
Python: A general-purpose programming language (Course 7 Week 1)
Ruby: An object-oriented programming language for web application development (Course 7 Week 1)
Swift: A programming language for macOS, iOS, watchOS, and tvOS (Course 7 Week 1)
Argument (R): Information needed by a function in R in order to run (Course 7 Week 2)
Assignment operator (R): An operator used to assign values to variables and vectors (Course 7 Week 2)
C#: An object-oriented programming language used to create games and mobile apps in the .NET open source developer platform (Course 7 Week 2)
C++: An extension of the C programming language that is used to create console games, such as those for Xbox (Course 7 Week 2)
Case study: A common way for employers to assess job skills and gain insight into how a candidate approaches common data-related challenges (Course 7 Week 2)
Conditional statement: A declaration that if a certain condition holds, then a certain event must take place (Course 7 Week 2)
CRAN (Comprehensive R Archive Network) (R): An online archive with R packages, source code, manuals, and documentation (Course 7 Week 2)
Data frame: A collection of columns containing data, similar to a spreadsheet or SQL table (Course 7 Week 2)
Data structure: A format for organizing and storing data (Course 7 Week 2)
dplyr (R): An R package in Tidyverse that offers a consistent set of functions to complete common data-manipulation tasks (Course 7 Week 2)
Factor (R): An object that stores categorical data where the data values are limited and usually based on a finite group, such as country or year (Course 7 Week 2)
Function (R): A body of reusable code for performing specific tasks in R (Course 7 Week 2)
ggplot2 (R): An R package in Tidyverse that creates a variety of data visualizations by applying different visual properties to the data variables in R (Course 7 Week 2)
Library: A directory containing all of a data analyst’s installed packages (Course 7 Week 2)
List: A vector whose elements can be of any type (Course 7 Week 2)
Logical operator: An operator that returns a logical data type (Course 7 Week 2)
Matrix: A two-dimensional collection of data elements with rows and columns (Course 7 Week 2)
Nested: Code that performs a particular function and is contained within code that performs a broader function (Course 7 Week 2)
Nested function: A function that is completely contained within another function (Course 7 Week 2)
Package (R): A unit of reproducible R code (Course 7 Week 2)
Pipe (R): A tool in R for expressing a sequence of multiple operations, represented with “%>%” (Course 7 Week 2)
readr (R): An R package in Tidyverse used for importing data (Course 7 Week 2)
tidyr (R): An R package in Tidyverse used for data cleaning to make tidy data (Course 7 Week 2)
Tidyverse (R): A system of packages in R with a common design philosophy for data manipulation, exploration, and visualization (Course 7 Week 2)
Variable (R): A representation of a value in R that can be stored for later use (Course 7 Week 2)
Vector (R): A group of data elements of the same type stored in a one-dimensional sequence in R (Course 7 Week 2)
Vignette (R): Documentation for an R package that describes the problem the package is designed to solve, explains how its functions can be used, and lists any dependencies on other packages (Course 7 Week 2)
Anscombe’s quartet: Four datasets that have nearly identical summary statistics but contain different plotted values (Course 7 Week 3)
Arithmetic operator: An operator used to perform basic math operations such as addition, subtraction, multiplication, and division (Course 7 Week 3)
Assignment operator: An operator used to assign values to variables and vectors (Course 7 Week 3)
FWF (fixed-width file): A text file with a specific format, which enables the saving of textual data in an organized fashion (Course 7 Week 3)
head() (R): An R function that returns a preview of the column names and the first few rows of a dataset (Course 7 Week 3)
Log file: A computer-generated file that records events from operating systems and other software programs (Course 7 Week 3)
mutate() (R): An R function that makes changes to a dataframe separating and merging columns or creating new variables (Course 7 Week 3)
Relational operator: An operator used to compare values, also known as a comparator (Course 7 Week 3)
Tibble (R): A streamlined variation of data frames (Course 7 Week 3)
Tidy data (R): A way of standardizing the organization of data within R (Course 7 Week 3)
TSV (Tab-separated values file): A text file that stores a data table by separating columns of data with tabs (Course 7 Week 3)
Aesthetic (R): A visual property of an object in a plot (Course 7 Week 4)
Analysis: The process used to make sense of the data collected (Course 7 Week 4)
Facets (R): A series of functions that splits data into subsets in a matrix of panels (Course 7 Week 4)
GAM (generalized additive model) smoothing (R): A process for smoothing plots with a large number of points (Course 7 Week 4)
Geom (R): The geometric object used to represent data (Course 7 Week 4)
Labels and annotations (R): A group of R functions used for customizing a plot (Course 7 Week 4)
Loess smoothing (R): A process used for smoothing plots with fewer than 1,000 points (Course 7 Week 4)
Mapping (R): The process of matching up a specific variable in a dataset with a specific aesthetic (Course 7 Week 4)
Smoothing (R): A process used to make data visualizations in R clearer and more readable (Course 7 Week 4)
Smoothing line (R): A line on a data visualization that uses smoothing to represent a trend (Course 7 Week 4)
Code chunk: A piece of code added in an R Markdown file that is used to process, visualize or analyze data (Course 7 Week 5)
Elevator pitch: A short statement describing an idea or concept (Course 7 Week 5)
HTML (Hypertext Markup Language): The set of markup symbols or codes used to create a webpage (Course 7 Week 5)
Inline code: Code that can be inserted directly into the text of an R Markdown file (Course 7 Week 5)
Jupyter Notebook: An open-source web application used to create and share documents that contain live code, equations, visualizations and narrative text (Course 7 Week 5)
Markdown (R): A syntax for formatting plain text files (Course 7 Week 5)
R Markdown: A file format for making dynamic documents with R (Course 7 Week 5)
R Notebook: A document for running code and displaying the graphs and charts that visualize the code (Course 7 Week 5)
Shiny (R): An R package used to build interactive web apps with R code (Course 7 Week 5)
YAML: A language that translates data to improve readability (Course 7 Week 5)

Glossary Items: 417